I've been / I'd been / Has been
or
Has been / Have been / Had been

In order to -> ke liye
Even if -> bhale hi
Alive with -> bhara hua.
If so -> Agar aisa hai to
In terms of -> Ke sambandh me
If i have my way -> Agar mera bs chale to
Can't take my eyes off ->
So long -> jitani der or samay ke liye
It appears/ seems that ->
So-So ->
As of now ->
Elope -> Run away secretly with one's beloved
Confide -> Unwrap, disclose, let on, bring out, reveal, discover, expose, divulge
Foe -> Enemy, foe, foeman, opposition
Enrich -> Improve in quality or make better
Sick of -> Disgusted, fed up, sick, tired of
Decency -> The quality of being polite and respectable
Spacious -> Very large in expanse or scope, broad, wide
campaign -> A race between condidates for elective office
covet -> wish, long or crave for, envy, desire, want, salivate, drool
Spanks -> A slap with the flat of the hand
Impersonate -> assume or act the character of
Replicate -> Bend or turn backward/ reproduce or make an exact copy of
feasible -> Executable, practicable, viable, workable, capable of being done with means at hand and circumstances as they are
Infatuated ->
Face-off -> Clash, Conflict, Skirmish, Fight, Battle, Combat Antonyms -> Accord, Agreement, Concord, Calm
Casuality -> Fatality, Mortality, Prey, Injured, Victim
Apprise -> Inform, Tell Notify, Update, Confide, Explain, Brief Antonyms-> Hide, Conceal, Cover up, Elide
Premeditated -> Planned, Intentional, Intended, Deliberate, Pre-planned Antonyms ->Accidental, Unintetional, Unplanned
Spontaneous -> happening or arising without apparent external cause
Brutal -> able or disposed to inflict pain or suffering
Ballot -> Vote, Referendum, Pole, Elect, Election
Secure -> Get, Obtain, Receive, Gain, Find, Acquire Antonyms-> Lose, Spend, Miss, Sink
Uncontested -> Unchallenged, Undisputed, Unopposed, Undeniable, Unquestioned, Antonyms-> Disputed, Contested, Deniable
Convention -> Agreement, Accord, Compact, Pact, Protocol, Treaty Antonyms ->Disagreement, discord, VAriance, Negation
Aspire -> Desire, Want, Hope, Aim for, Intend, Wish Antonyms -> Despise, Hate, Dislike, Abominate
Urge -> force or impel in an indicated direction
Superficial -> concerned with or comprehending only what is apparent or obvious; not deep or penetrating emotionally or intellectually
Indistinct -> not clearly defined or easy to perceive or understand
Various -> of many different kinds purposefully arranged but lacking any uniformity
Pursue -> follow in or as if in pursuit
Valiant -> having or showing valor
Literally -> in a literal sense
Negation -> A Negative statement; a statement that is a refusal or denial of some other statement
Concubines ->  woman who cohabits with an important man
Abscess ->  To form a pus filled cavity typically from an infection
Ascend -> travel up, go along towards (a river's) source
Ascent -> a movement upward
Crescent -> any shape resembling the curved shape of the moon in its first or last quarters
Conscience -> motivation deriving logically from ethical or moral principles that govern a person's thoughts and actions
Descend -> move downward and lower, but not necessarily all the way
Descent -> a movement downward
Fluorescent -> emitting light during exposure to radiation from an external source
Luminescent -> emitting light not caused by heat
Obscene -> Filthy
Scenic -> a depiction of scenery, used of locations; having beautiful natural scenery
Scent -> a distinctive odor that is pleasant, an odor left in passing by which a person or animal can be traced
Resuscitate -> Verb-> cause to regain consciousness Adjective->  Restored to life
Incandescent -> Adjective-> emitting light as a result of being heated Noun-> An incandescent lamp or bulb
Cranky -> easily irritated or annoyed, inclined to heel over easily under sail
Proficient -> Adjective-> shaving or showing knowledge and skill and aptitude Noun-> An expert
Embrace -> hold (someone) tightly in your arms, usually with fondness
Infuriate -> make furious, Enraged; furiously angry; infuriated
Piping Hot -> Very hot
Rumble -> verb->make a low noise, to utter or emit low dull rumbling sounds, Noun-> a loud low dull continuous noise
Delicate -> exquisitely fine and subtle and pleasing; susceptible to injury, marked by great skill especially in meticulous technique
Snoop -> watch, observe, or inquire secretly
Wail -> emit long loud cries, cry weakly or softly, a cry of sorrow and grief
Meddle -> intrude in other people's affairs or business; interfere unwantedly
Eventually -> after an unspecified period of time or an especially long delay
Compensate -> compensate, counterbalance, correct, make up, even out, even off, even up
Seasoning -> something added to food primarily for the savor it imparts
Soothing -> Comfy, Comfortable
Manipulate -> influence or control shrewdly or deviously
Severe ->
Rebuke -> censure severely or angrily
Reticent -> temperamentally disinclined to talk
Encourage ->
Imbecile -> A person of subnormal intelligence or having a mental age of three to seven years
Etiquette ->
Tyranny ->dictatorship, absolutism, authoritarianism, Caesarism, despotism, monocracy, one-man rule, shogunate, Stalinism,
 totalitarianism, tyranny